46 46 46 46 46 46 46 46 46 46 46 46 46 46 46 46 46 46 46 46 46 46 46 46 46 46 46 46 46 46 46 46 46 46 46 46 46 46 46 46 46 46 46 46 46 46 46 46 46 46
46 46 46 46 46 46 46 46 46 46 46 46 29 30 30 30 31 46 46 46 46 46 46 46 46 46 46 46 46 46 46 46 46 46 46 46 46 46 46 46 46 46 46 46 46 46 46 46 46 46
46 46 46 46 46 46 46 46 46 46 46 29 38 35 35 47 37 30 31 46 46 46 46 46 46 46 46 46 46 46 46 46 46 46 46 46 46 46 46 46 46 46 46 46 46 46 46 46 46 46
46 46 46 46 46 46 46 46 46 46 46 34 35 47 35 35 47 35 36 46 46 46 46 46 46 46 46 46 46 46 11 12 12 12 12 12 12 13 46 46 46 46 46 46 46 46 46 46 46 46
46 46 46 46 46 46 46 46 46 46 46 39 40 40 33 35 32 40 41 46 46 46 46 46 46 46 46 46 46 46 19 20 20 20 20 20 20 21 46 46 46 46 46 46 46 46 46 46 46 46
46 46 46 46 46 46 46 46 46 46 46 46 46 46 39 40 41 46 46 46 46 46 46 46 46 46 46 46 46 46 19 20 20 20 20 20 20 21 46 46 46 46 46 46 46 46 46 46 46 46
46 46 46 46 46 46 46 46 46 46 46 46 11 12 12 12 12 13 46 46 46 46 46 46 46 46 46 46 46 46 19 20 20 20 20 20 20 21 46 46 46 46 46 46 46 46 46 46 46 46
46 46 46 46 46 46 46 45 45 45 45 45 19 20 20 20 20 27 12 12 12 12 12 12 12 12 12 12 12 12 28 20 20 20 20 20 20 21 46 46 46 46 46 46 46 46 46 46 46 46
46 46 46 46 46 46 46 45 44 44 44 45 25 17 18 20 20 20 20 20 20 20 20 20 20 20 20 20 20 20 20 20 20 20 20 20 20 21 46 46 46 46 46 46 46 46 46 46 46 46
46 46 46 46 46 46 46 45 44 44 44 45 46 46 19 20 16 17 17 17 17 18 20 16 17 17 17 17 17 17 17 17 17 17 17 17 17 26 46 46 46 46 46 46 46 46 46 46 46 46
46 46 46 46 46 46 46 45 44 44 44 45 46 46 19 20 21 46 46 46 46 19 20 21 46 46 46 46 46 46 46 46 46 46 46 46 46 46 46 46 46 46 46 46 46 46 46 46 46 46
46 46 46 46 46 46 46 45 44 44 44 45 46 46 19 20 21 46 46 46 46 19 20 21 46 46 46 46 46 46 46 46 46 46 46 46 46 46 46 46 46 46 46 46 46 46 46 46 46 46
46 46 46 46 46 46 46 45 45 44 45 45 46 46 19 20 21 46 46 46 46 19 20 21 46 46 46 46 46 46 46 46 46 46 46 46 46 46 46 46 46 46 46 46 46 46 46 46 46 46
46 46 46 46 46 46 46 46 19 20 21 46 46 46 19 20 21 46 46 46 46 19 20 21 46 46 46 46 46 46 46 46 46 46 46 46 46 46 46 46 46 46 46 46 46 46 46 46 46 46
46 46 46 46 46 46 46 46 19 20 21 46 46 46 19 20 21 46 46 46 46 19 20 21 46 46 46 46 46 46 46 46 46 46 46 46 46 46 46 46 46 46 46 46 46 46 46 46 46 46
46 46 46 46 46 46 11 12 28 20 27 12 12 12 28 20 21 46 46 46 46 19 20 21 46 46 46 46 46 46 46 46 46 46 46 46 46 46 46 46 46 46 46 46 46 46 46 46 46 46
46 46 46 46 46 46 19 20 20 20 20 20 20 20 20 20 21 46 46 46 46 19 20 21 46 46 46 46 46 46 46 46 46 46 46 46 46 46 46 46 46 46 46 46 46 46 46 46 46 46
46 46 46 46 46 46 19 20 16 17 17 17 17 17 17 17 26 46 46 46 46 19 20 21 46 46 46 11 12 12 12 12 12 12 13 46 46 46 46 46 46 46 46 46 46 46 46 46 46 46
46 46 46 46 46 46 19 20 21 46 46 46 46 46 46 46 46 46 46 46 46 19 20 21 46 46 46 19 20 20 20 20 20 20 21 46 46 46 46 46 46 46 46 46 46 46 46 46 46 46
46 46 46 46 46 46 19 20 21 46 46 46 46 46 46 46 46 46 46 46 46 19 20 21 46 46 46 19 20 16 17 17 18 20 21 46 46 46 46 46 46 46 46 46 46 46 46 46 46 46
46 46 46 46 46 46 19 20 27 12 12 12 13 46 46 46 46 46 46 46 46 19 20 21 46 46 46 19 20 21 46 46 19 20 27 12 13 46 46 46 46 46 46 46 46 46 46 46 46 46
46 46 46 46 46 46 19 20 20 20 20 20 21 46 46 46 46 46 46 46 46 19 20 21 46 46 46 19 20 21 46 46 19 20 20 20 21 46 46 46 46 46 46 46 46 46 46 46 46 46
46 46 46 46 46 46 25 17 17 17 18 20 21 46 46 46 46 11 12 12 12 28 20 27 12 12 12 28 20 21 46 46 25 17 17 17 26 46 46 46 46 46 46 46 46 46 46 46 46 46
46 46 46 46 46 46 46 46 46 46 19 20 21 46 46 46 46 19 20 20 20 20 20 20 20 20 20 20 20 21 46 46 46 46 46 46 46 46 46 46 46 46 46 46 46 46 46 46 46 46
46 46 46 46 46 46 46 46 46 46 19 20 27 12 12 12 12 28 20 16 17 18 20 16 17 17 17 17 17 26 46 46 46 46 46 46 46 46 46 46 46 46 46 46 46 46 46 46 46 46
46 46 46 46 46 46 46 46 46 46 19 20 20 20 20 20 20 20 20 21 46 19 20 21 46 46 46 46 46 46 46 46 46 46 46 46 46 46 46 46 46 46 46 46 46 46 46 46 46 46
46 46 46 46 46 46 46 46 46 46 25 17 17 17 17 17 17 17 17 26 46 19 20 21 46 46 46 46 46 46 46 46 46 46 46 46 46 46 46 46 46 46 46 46 46 46 46 46 46 46
46 46 46 46 46 46 46 46 46 46 46 46 46 46 46 46 46 46 46 46 46 19 20 21 46 46 46 46 46 46 46 46 46 46 46 46 46 46 46 46 46 46 46 46 46 46 46 46 46 46
46 46 46 46 46 46 46 46 46 46 46 46 46 46 46 46 46 46 46 46 46 19 20 21 46 46 46 46 46 46 46 46 46 46 46 46 46 46 46 46 46 46 46 46 46 46 46 46 46 46
46 46 46 46 46 46 46 46 46 46 46 46 46 46 46 46 46 46 46 46 46 19 20 21 46 46 46 46 46 46 46 46 46 46 46 46 46 46 46 46 46 46 46 46 46 46 46 46 46 46
46 46 46 46 46 46 46 46 46 46 46 46 46 46 46 46 46 46 46 46 46 19 20 21 46 46 46 46 46 46 46 46 46 46 46 46 46 46 46 46 46 46 46 46 46 46 46 46 46 46
46 46 46 46 46 46 46 46 46 46 46 46 46 46 46 46 46 46 46 46 46 19 20 21 46 46 46 46 46 46 46 46 46 46 46 46 46 46 46 46 46 46 46 46 46 46 46 46 46 46
46 46 46 46 46 46 46 46 46 46 46 46 46 46 46 46 46 46 46 46 46 19 20 21 46 46 46 46 46 46 46 46 46 46 46 46 46 46 46 46 46 46 46 46 46 46 46 46 46 46
46 46 46 46 46 46 46 46 46 46 46 46 46 46 46 46 46 46 11 12 12 28 20 21 46 46 46 46 46 46 46 46 46 46 46 46 46 46 46 46 46 46 46 46 46 46 46 46 46 46
46 46 46 46 46 46 46 46 46 46 46 46 11 12 12 12 13 46 19 20 20 20 20 21 46 46 46 46 46 46 46 46 46 46 46 46 46 46 46 46 46 46 46 46 46 46 46 46 46 46
46 46 46 46 46 46 46 46 46 46 46 46 19 20 20 20 21 46 19 20 16 17 17 26 46 46 46 46 46 46 46 46 46 46 46 46 46 46 46 46 46 46 46 46 46 46 46 46 46 46
46 46 46 46 46 46 46 46 46 46 46 46 19 20 20 20 27 12 28 20 21 46 46 46 46 46 46 46 46 46 46 46 46 46 46 46 46 46 46 46 46 46 46 46 46 46 46 46 46 46
46 46 46 46 46 46 46 46 46 46 46 46 19 20 20 20 20 16 17 17 26 46 46 46 46 46 46 46 46 46 46 46 46 46 46 46 46 46 46 46 46 46 46 46 46 46 46 46 46 46
46 46 46 46 46 46 46 46 46 46 46 46 19 20 20 20 20 21 46 46 46 46 46 46 46 46 46 46 46 46 46 46 46 46 46 46 46 46 46 46 46 46 46 46 46 46 46 46 46 46
46 46 46 46 46 46 46 46 46 46 46 46 25 17 17 17 17 26 46 46 46 46 46 46 46 46 46 46 46 46 46 46 46 46 46 46 46 46 46 46 46 46 46 46 46 46 46 46 46 46
46 46 46 46 46 46 46 46 46 46 46 46 46 46 46 46 46 46 46 46 46 46 46 46 46 46 46 46 46 46 46 46 46 46 46 46 46 46 46 46 46 46 46 46 46 46 46 46 46 46
46 46 46 46 46 46 46 46 46 46 46 46 46 46 46 46 46 46 46 46 46 46 46 46 46 46 46 46 46 46 46 46 46 46 46 46 46 46 46 46 46 46 46 46 46 46 46 46 46 46
46 46 46 46 46 46 46 46 46 46 46 46 46 46 46 46 46 46 46 46 46 46 46 46 46 46 46 46 46 46 46 46 46 46 46 46 46 46 46 46 46 46 46 46 46 46 46 46 46 46
46 46 46 46 46 46 46 46 46 46 46 46 46 46 46 46 46 46 46 46 46 46 46 46 46 46 46 46 46 46 46 46 46 46 46 46 46 46 46 46 46 46 46 46 46 46 46 46 46 46
46 46 46 46 46 46 46 46 46 46 46 46 46 46 46 46 46 46 46 46 46 46 46 46 46 46 46 46 46 46 46 46 46 46 46 46 46 46 46 46 46 46 46 46 46 46 46 46 46 46
46 46 46 46 46 46 46 46 46 46 46 46 46 46 46 46 46 46 46 46 46 46 46 46 46 46 46 46 46 46 46 46 46 46 46 46 46 46 46 46 46 46 46 46 46 46 46 46 46 46
46 46 46 46 46 46 46 46 46 46 46 46 46 46 46 46 46 46 46 46 46 46 46 46 46 46 46 46 46 46 46 46 46 46 46 46 46 46 46 46 46 46 46 46 46 46 46 46 46 46
46 46 46 46 46 46 46 46 46 46 46 46 46 46 46 46 46 46 46 46 46 46 46 46 46 46 46 46 46 46 46 46 46 46 46 46 46 46 46 46 46 46 46 46 46 46 46 46 46 46
46 46 46 46 46 46 46 46 46 46 46 46 46 46 46 46 46 46 46 46 46 46 46 46 46 46 46 46 46 46 46 46 46 46 46 46 46 46 46 46 46 46 46 46 46 46 46 46 46 46
46 46 46 46 46 46 46 46 46 46 46 46 46 46 46 46 46 46 46 46 46 46 46 46 46 46 46 46 46 46 46 46 46 46 46 46 46 46 46 46 46 46 46 46 46 46 46 46 46 46